#####
#@$.#
#####
;
++########
##+++++++#
#+++.++++#
#+++$++++#
#+.$@$.++#
####$++++#
+++#.++++#
+++#++++##
+++#####++
;
            ######
            #++++####
            #+####++#
            #+++++++#
#############+###+++#
#.+++++++++##+$+++###
#.+++++++++++$++++##
#.+++++++++##+++$+@#
#############+++++##
            #++++++#
            ###+##+#
              #++++#
              ######
